2 2 2 2 2 2 2 2 2 2 2 2 2 2 2 2 2 2 2 2 
2 0 0 0 2 2 0 2 0 0 2 0 0 2 0 0 0 2 0 2 
2 2 0 2 2 0 0 2 2 0 0 0 2 0 2 2 0 0 0 2 
2 0 2 0 2 2 2 2 0 0 2 0 0 0 0 2 2 2 0 2 
2 0 2 0 2 2 0 0 2 0 0 2 0 0 0 0 2 0 2 2 
2 0 0 0 0 0 0 0 0 2 0 2 0 0 0 2 2 0 0 2 
2 0 0 0 0 0 2 2 0 2 2 0 0 0 0 0 0 0 2 2 
2 0 0 0 0 0 0 0 0 0 0 2 0 0 0 0 2 2 0 2 
2 0 0 0 0 2 0 2 0 0 2 0 0 0 0 0 0 0 0 2 
2 2 0 0 2 2 0 0 0 0 0 0 2 0 2 2 0 2 0 2 
2 2 2 0 0 0 0 0 2 2 9 0 0 0 0 0 0 0 0 2 
2 0 0 0 2 0 2 0 0 2 0 2 0 0 0 0 0 0 0 2 
2 0 0 0 0 0 0 0 2 0 0 0 2 0 0 2 0 0 0 2 
2 0 2 2 2 0 0 0 0 0 2 0 0 0 0 0 2 0 0 2 
2 0 0 0 2 0 2 0 2 0 2 0 0 0 2 0 2 0 0 2 
2 0 0 2 0 0 0 0 2 0 0 0 2 0 0 2 2 2 0 2 
2 0 0 2 0 0 0 0 2 0 0 2 2 2 0 2 0 0 2 2 
2 0 0 0 0 2 0 0 2 2 0 2 0 0 0 2 0 0 0 2 
2 0 0 0 0 0 0 2 2 0 2 0 0 0 0 0 0 2 0 2 
2 2 2 2 2 2 2 2 2 2 2 2 2 2 2 2 5 2 2 2 
